DEPCOMCAN;FRACAN;PMUN;PCAP;PTOT;
0105305;Bourg-en-Bresse-1;28968;1109;30077;
0105306;Bourg-en-Bresse-2;12559;670;13229;
0133804;Belley;833;27;860;
0133811;Lagnieu;360;9;369;
0240809;Laon-1;8747;166;8913;
0240810;Laon-2;16129;507;16636;
0269113;Saint-Quentin-1;19400;418;19818;
0269114;Saint-Quentin-2;18158;597;18755;
0269115;Saint-Quentin-3;16258;267;16525;
0272216;Soissons-1;11087;193;11280;
0272217;Soissons-2;17443;453;17896;
0318509;Montluçon-1;3788;56;3844;
0318510;Montluçon-2;11939;465;12404;
0318511;Montluçon-3;10184;299;10483;
0318512;Montluçon-4;9742;273;10015;
0319013;Moulins-1;10858;373;11231;
0319014;Moulins-2;8806;190;8996;
0331017;Vichy-1;11951;177;12128;
0331018;Vichy-2;12215;180;12395;
0407004;Digne-les-Bains-1;10216;542;10758;
0407005;Digne-les-Bains-2;6244;327;6571;
0411207;Manosque-1;7868;108;7976;
0411208;Manosque-2;6940;205;7145;
0411209;Manosque-3;7525;346;7871;
0502302;Briançon-1;1901;55;1956;
0502303;Briançon-2;9724;270;9994;
0506106;Gap-1;10336;311;10647;
0506107;Gap-2;10696;589;11285;
0506108;Gap-3;10111;279;10390;
0506109;Gap-4;9752;413;10165;
0600401;Antibes-1;11071;123;11194;
0600402;Antibes-2;30632;275;30907;
0600403;Antibes-3;25577;465;26042;
0600425;Valbonne;5719;299;6018;
0602705;Cagnes-sur-Mer-1;42593;360;42953;
0602706;Cagnes-sur-Mer-2;8335;118;8453;
0602907;Cannes-1;32593;300;32893;
0602908;Cannes-2;41275;518;41793;
0603007;Cannes-1;14097;169;14266;
0603009;Le Cannet;27374;224;27598;
0606911;Grasse-1;20002;349;20351;
0606912;Grasse-2;30394;597;30991;
0608815;Nice-1;42912;397;43309;
0608816;Nice-2;47386;396;47782;
0608817;Nice-3;23267;225;23492;
0608818;Nice-4;42419;407;42826;
0608819;Nice-5;46147;326;46473;
0608820;Nice-6;41841;586;42427;
0608821;Nice-7;23433;134;23567;
0608822;Nice-8;38769;185;38954;
0608823;Nice-9;33843;306;34149;
0701001;Annonay-1;9584;391;9975;
0701002;Annonay-2;6761;220;6981;
0701903;Aubenas-1;6737;403;7140;
0701904;Aubenas-2;5435;358;5793;
0810504;Charleville-Mézières-1;10135;174;10309;
0810505;Charleville-Mézières-2;8886;179;9065;
0810506;Charleville-Mézières-3;14258;598;14856;
0810507;Charleville-Mézières-4;13149;192;13341;
0811514;Sedan-1;121;5;126;
0811519;Vouziers;457;8;465;
0840914;Sedan-1;5442;126;5568;
0840915;Sedan-2;5076;134;5210;
0840916;Sedan-3;5910;89;5999;
0849001;Attigny;314;6;320;
0849019;Vouziers;4026;143;4169;
0922507;Pamiers-1;5843;154;5997;
0922508;Pamiers-2;9832;316;10148;
1038712;Troyes-1;21013;345;21358;
1038713;Troyes-2;6913;72;6985;
1038714;Troyes-3;8815;380;9195;
1038715;Troyes-4;6388;29;6417;
1038716;Troyes-5;18523;350;18873;
1106902;Carcassonne-1;15026;490;15516;
1106903;Carcassonne-2;14187;501;14688;
1106904;Carcassonne-3;16818;343;17161;
1126211;Narbonne-1;21329;313;21642;
1126212;Narbonne-2;15079;430;15509;
1126213;Narbonne-3;18292;433;18725;
1214511;Millau-1;11237;469;11706;
1214512;Millau-2;10872;266;11138;
1220216;Rodez-1;11876;988;12864;
1220217;Rodez-2;10101;806;10907;
1220218;Rodez-Onet;2080;54;2134;
1300101;Aix-en-Provence-1;73146;2071;75217;
1300102;Aix-en-Provence-2;69336;1123;70459;
1320312;Marseille-1;5514;23;5537;
1320313;Marseille-2;43250;203;43453;
1320412;Marseille-1;24696;206;24902;
1320416;Marseille-5;16064;70;16134;
1320418;Marseille-7;7699;56;7755;
1320512;Marseille-1;6112;38;6150;
1320522;Marseille-11;40087;262;40349;
1320622;Marseille-11;24195;248;24443;
1320623;Marseille-12;18632;174;18806;
1320821;Marseille-10;28928;376;29304;
1320823;Marseille-12;25285;231;25516;
1320820;Marseille-9;26815;573;27388;
1320921;Marseille-10;27868;194;28062;
1320920;Marseille-9;48046;464;48510;
1321021;Marseille-10;19811;71;19882;
1321022;Marseille-11;12326;55;12381;
1321019;Marseille-8;24001;248;24249;
1321118;Marseille-7;14663;184;14847;
1321119;Marseille-8;42127;273;42400;
1321218;Marseille-7;57621;579;58200;
1321219;Marseille-8;3013;12;3025;
1321316;Marseille-5;19276;254;19530;
1321317;Marseille-6;72716;482;73198;
1321415;Marseille-4;30575;101;30676;
1321416;Marseille-5;32376;170;32546;
1321514;Marseille-3;45670;183;45853;
1321515;Marseille-4;30231;134;30365;
1310326;Salon-de-Provence-1;19359;240;19599;
1310327;Salon-de-Provence-2;26169;342;26511;
1411805;Caen-1;17688;292;17980;
1411806;Caen-2;20361;224;20585;
1411807;Caen-3;24771;957;25728;
1411808;Caen-4;26410;436;26846;
1411809;Caen-5;16124;260;16384;
1402701;Aunay-sur-Odon;4335;58;4393;
1402710;Condé-sur-Noireau;334;7;341;
1501402;Aurillac-1;5851;166;6017;
1501403;Aurillac-2;9271;829;10100;
1501404;Aurillac-3;10377;334;10711;
1514209;Neuvéglise;1371;28;1399;
1514212;Saint-Flour-2;375;15;390;
1502701;Arpajon-sur-Cère;462;10;472;
1502706;Maurs;321;4;325;
1518711;Saint-Flour-1;1728;122;1850;
1518712;Saint-Flour-2;4707;390;5097;
1601501;Angoulême-1;14828;419;15247;
1601502;Angoulême-2;13251;518;13769;
1601503;Angoulême-3;13661;736;14397;
1610211;Cognac-1;8630;187;8817;
1610212;Cognac-2;10195;263;10458;
1619206;Charente-Bonnieure;3192;57;3249;
1619210;Charente-Vienne;761;48;809;
1745718;Saint-Jean-d'Angély;274;2;276;
1745723;Surgères;847;15;862;
1730014;La Rochelle-1;26522;395;26917;
1730015;La Rochelle-2;25089;1020;26109;
1730016;La Rochelle-3;24124;705;24829;
1803303;Bourges-1;17780;505;18285;
1803304;Bourges-2;15341;194;15535;
1803305;Bourges-3;14587;553;15140;
1803306;Bourges-4;16843;786;17629;
1827918;Vierzon-1;15294;335;15629;
1827919;Vierzon-2;10609;203;10812;
1901002;Argentat;2874;119;2993;
1901014;Sainte-Fortunade;142;1;143;
1903103;Brive-la-Gaillarde-1;12389;376;12765;
1903104;Brive-la-Gaillarde-2;12770;445;13215;
1903105;Brive-la-Gaillarde-3;8340;109;8449;
1903106;Brive-la-Gaillarde-4;13417;356;13773;
2A00401;Ajaccio-1;16706;159;16865;
2A00402;Ajaccio-2;14083;220;14303;
2A00403;Ajaccio-3;17183;190;17373;
2A00404;Ajaccio-4;14128;157;14285;
2A00405;Ajaccio-5;8559;123;8682;
2A24706;Bavella;5960;110;6070;
2A24707;Grand Sud;6082;119;6201;
2B03301;Bastia-1;9284;179;9463;
2B03302;Bastia-2;12318;193;12511;
2B03303;Bastia-3;14635;92;14727;
2B03304;Bastia-4;9478;255;9733;
2123108;Dijon-1;25469;578;26047;
2123109;Dijon-2;28613;448;29061;
2123110;Dijon-3;24460;604;25064;
2123111;Dijon-4;28116;551;28667;
2123112;Dijon-5;25208;581;25789;
2123113;Dijon-6;25054;522;25576;
2209306;Lamballe;14362;419;14781;
2209317;Pléneuf-Val-André;2216;40;2256;
2227824;Saint-Brieuc-1;21908;774;22682;
2227825;Saint-Brieuc-2;22464;860;23324;
2309612;Guéret-1;5303;102;5405;
2309613;Guéret-2;7858;501;8359;
2402605;Le Haut-Périgord Noir;1844;40;1884;
2402607;Isle-Manoire;2654;42;2696;
2403701;Bergerac-1;18463;513;18976;
2403702;Bergerac-2;8370;221;8591;
2436420;Terrasson-Lavilledieu;212;8;220;
2436425;Vallée de l'Homme;380;12;392;
2432214;Périgueux-1;15758;858;16616;
2432215;Périgueux-2;14208;728;14936;
2431207;Isle-Manoire;4281;100;4381;
2431212;Périgord Central;267;3;270;
2505604;Besançon-1;20258;420;20678;
2505605;Besançon-2;17268;503;17771;
2505606;Besançon-3;22433;829;23262;
2505607;Besançon-4;24178;487;24665;
2505608;Besançon-5;10893;417;11310;
2505609;Besançon-6;20904;659;21563;
2522215;Ornans;180;8;188;
2522218;Valdahon;1370;28;1398;
2524508;Besançon-5;1028;20;1048;
2524509;Besançon-6;273;7;280;
2533411;Frasne;2065;223;2288;
2533415;Ornans;118;3;121;
2619808;Montélimar-1;21117;696;21813;
2619809;Montélimar-2;17980;434;18414;
2628101;Bourg-de-Péage;17087;447;17534;
2628111;Romans-sur-Isère;16073;225;16298;
2636215;Valence-1;5340;46;5386;
2636216;Valence-2;16684;428;17112;
2636217;Valence-3;14056;344;14400;
2636218;Valence-4;27634;496;28130;
2722909;Évreux-1;17382;737;18119;
2722910;Évreux-2;18915;332;19247;
2722911;Évreux-3;11436;230;11666;
2715706;Breteuil;841;13;854;
2715722;Verneuil-sur-Avre;546;7;553;
2719806;Breteuil;878;15;893;
2719822;Verneuil-sur-Avre;5244;237;5481;
2742502;Bernay;278;3;281;
2742507;Brionne;2116;43;2159;
2726304;Bourg-Achard;543;7;550;
2726317;Pont-Audemer;690;6;696;
2708905;Bourgtheroulde-Infreville;841;13;854;
2708917;Pont-Audemer;176;4;180;
2751602;Bernay;1196;30;1226;
2751606;Breteuil;224;3;227;
2767906;Breteuil;1285;28;1313;
2767922;Verneuil-sur-Avre;6885;375;7260;
2808504;Chartres-1;17126;440;17566;
2808505;Chartres-2;9640;249;9889;
2808506;Chartres-3;11812;496;12308;
2812703;Brou;356;8;364;
2812707;Châteaudun;918;12;930;
2813408;Dreux-1;10814;153;10967;
2813409;Dreux-2;20230;408;20638;
2818302;Auneau;38;0;38;
2818315;Voves;647;3;650;
2901901;Brest-1;31148;393;31541;
2901902;Brest-2;36557;505;37062;
2901903;Brest-3;18954;587;19541;
2901904;Brest-4;17019;252;17271;
2901905;Brest-5;36386;947;37333;
2923223;Quimper-1;24048;974;25022;
2923224;Quimper-2;38937;1521;40458;
3000702;Alès-1;12032;283;12315;
3000703;Alès-2;12699;151;12850;
3000704;Alès-3;15488;217;15705;
3018910;Nîmes-1;36504;771;37275;
3018911;Nîmes-2;38081;367;38448;
3018912;Nîmes-3;37503;566;38069;
3018913;Nîmes-4;38040;638;38678;
3018919;Saint-Gilles;482;0;482;
3155515;Toulouse-1;56177;739;56916;
3155524;Toulouse-10;23475;438;23913;
3155525;Toulouse-11;34511;418;34929;
3155516;Toulouse-2;56609;471;57080;
3155517;Toulouse-3;51808;629;52437;
3155518;Toulouse-4;52846;618;53464;
3155519;Toulouse-5;44636;323;44959;
3155520;Toulouse-6;56137;392;56529;
3155521;Toulouse-7;9285;78;9363;
3155522;Toulouse-8;61416;666;62082;
3155523;Toulouse-9;32653;484;33137;
3201304;Auch-1;6789;567;7356;
3201305;Auch-2;5747;342;6089;
3201306;Auch-3;9399;223;9622;
3303931;Talence;6744;55;6799;
3303933;Villenave-d'Ornon;21857;299;22156;
3306302;Bordeaux-1;45887;482;46369;
3306303;Bordeaux-2;49907;978;50885;
3306304;Bordeaux-3;47904;844;48748;
3306305;Bordeaux-4;58926;553;59479;
3306306;Bordeaux-5;51812;511;52323;
3310627;Le Réolais et Les Bastides;294;9;303;
3310629;Le Sud-Gironde;1158;9;1167;
3328118;Mérignac-1;37862;393;38255;
3328119;Mérignac-2;32243;317;32560;
3331823;Pessac-1;32158;420;32578;
3331824;Pessac-2;31650;286;31936;
3403202;Béziers-1;19182;257;19439;
3403203;Béziers-2;37904;504;38408;
3403204;Béziers-3;20091;515;20606;
3417220;Montpellier - Castelnau-le-Lez;24486;583;25069;
3417215;Montpellier-1;44557;365;44922;
3417216;Montpellier-2;53456;468;53924;
3417217;Montpellier-3;50908;1001;51909;
3417218;Montpellier-4;60826;426;61252;
3417219;Montpellier-5;50888;636;51524;
3511508;Fougères-1;6023;296;6319;
3511509;Fougères-2;14395;384;14779;
3516308;Fougères-1;556;9;565;
3516309;Fougères-2;1295;21;1316;
3523818;Rennes-1;40082;792;40874;
3523819;Rennes-2;41186;1139;42325;
3523820;Rennes-3;33252;354;33606;
3523821;Rennes-4;36420;551;36971;
3523822;Rennes-5;31718;724;32442;
3523823;Rennes-6;34157;550;34707;
3528825;Saint-Malo-1;29968;917;30885;
3528826;Saint-Malo-2;16129;348;16477;
3604405;Châteauroux-1;9177;309;9486;
3604406;Châteauroux-2;16537;666;17203;
3604407;Châteauroux-3;18027;602;18629;
3620204;Buzançais;3191;65;3256;
3620210;Levroux;451;10;461;
3726115;Tours-1;39445;956;40401;
3726116;Tours-2;32987;492;33479;
3726117;Tours-3;31615;805;32420;
3726118;Tours-4;31740;576;32316;
3816906;Fontaine-Seyssinet;10943;77;11020;
3816907;Fontaine-Vercors;11580;190;11770;
3818509;Grenoble-1;45156;873;46029;
3818510;Grenoble-2;20626;233;20859;
3818511;Grenoble-3;49045;626;49671;
3818512;Grenoble-4;43627;439;44066;
3854427;Vienne-1;15849;178;16027;
3854428;Vienne-2;13457;199;13656;
3901703;Bletterans;771;14;785;
3901712;Poligny;456;8;464;
3901809;Moirans-en-Montagne;566;18;584;
3901813;Saint-Amour;86;0;86;
3902109;Moirans-en-Montagne;270;6;276;
3902113;Saint-Amour;332;7;339;
3949114;Saint-Claude;324;11;335;
3949116;Saint-Lupicin;2073;60;2133;
3919002;Authume;125;1;126;
3919010;Mont-sous-Vaudrey;1153;26;1179;
3919805;Dole-1;13176;483;13659;
3919806;Dole-2;10532;415;10947;
3919903;Bletterans;225;4;229;
3919912;Poligny;1007;28;1035;
3928609;Moirans-en-Montagne;539;23;562;
3928616;Saint-Lupicin;1898;84;1982;
3930007;Lons-le-Saunier-1;7571;359;7930;
3930008;Lons-le-Saunier-2;9720;373;10093;
3913014;Saint-Claude;180;9;189;
3913015;Saint-Laurent-en-Grandvaux;626;13;639;
3953708;Lons-le-Saunier-2;387;11;398;
3953713;Saint-Amour;72;0;72;
4008805;Dax-1;1863;26;1889;
4008806;Dax-2;18818;805;19623;
4019210;Mont-de-Marsan-1;19169;976;20145;
4019211;Mont-de-Marsan-2;10385;464;10849;
4101802;Blois-1;21050;199;21249;
4101803;Blois-2;13966;690;14656;
4101804;Blois-3;8798;710;9508;
4101815;Vineuil;2272;30;2302;
4105904;Blois-3;2248;69;2317;
4105907;Montrichard;4618;79;4697;
4218711;Roanne-1;21413;534;21947;
4218712;Roanne-2;12953;159;13112;
4221814;Saint-Etienne-1;39415;483;39898;
4221815;Saint-Etienne-2;16262;194;16456;
4221816;Saint-Etienne-3;25437;219;25656;
4221817;Saint-Etienne-4;28875;314;29189;
4221818;Saint-Etienne-5;22789;120;22909;
4221819;Saint-Etienne-6;39787;625;40412;
4315712;Le Puy-en-Velay-1;4857;108;4965;
4315713;Le Puy-en-Velay-2;4735;173;4908;
4315714;Le Puy-en-Velay-3;1804;162;1966;
4315715;Le Puy-en-Velay-4;7599;506;8105;
4400510;Machecoul;2589;40;2629;
4400520;Pornic;4170;69;4239;
4410911;Nantes-1;43716;1076;44792;
4410912;Nantes-2;40739;800;41539;
4410913;Nantes-3;51033;711;51744;
4410914;Nantes-4;38849;696;39545;
4410915;Nantes-5;41248;442;41690;
4410916;Nantes-6;46042;765;46807;
4410917;Nantes-7;47719;667;48386;
4414321;Rezé-1;5270;81;5351;
4414322;Rezé-2;36141;662;36803;
4416224;Saint-Herblain-1;23487;461;23948;
4416225;Saint-Herblain-2;22781;269;23050;
4418426;Saint-Nazaire-1;48942;1399;50341;
4418427;Saint-Nazaire-2;21051;380;21431;
4523405;La Ferté-Saint-Aubin;13558;164;13722;
4523413;Orléans-1;24312;290;24602;
4523414;Orléans-2;26538;789;27327;
4523415;Orléans-3;14604;199;14803;
4523416;Orléans-4;37673;958;38631;
4604201;Cahors-1;6798;203;7001;
4604202;Cahors-2;6358;574;6932;
4604203;Cahors-3;6722;153;6875;
4613804;Causse et Bouriane;180;2;182;
4613805;Causse et Vallées;774;18;792;
4610207;Figeac-1;5663;423;6086;
4610208;Figeac-2;4129;258;4387;
4603312;Luzech;153;2;155;
4603315;Puy-l'Evêque;423;8;431;
4626802;Cahors-2;417;10;427;
4626805;Causse et Vallées;446;8;454;
4700101;Agen-1;6085;53;6138;
4700102;Agen-2;1906;9;1915;
4700103;Agen-3;16494;497;16991;
4700104;Agen-4;9091;282;9373;
4715713;Marmande-1;8556;326;8882;
4715714;Marmande-2;9135;263;9398;
4732320;Villeneuve-sur-Lot-1;14316;335;14651;
4732321;Villeneuve-sur-Lot-2;7748;370;8118;
4814602;La Canourgue;527;21;548;
4814605;Florac;426;10;436;
4809509;Mende-1;6076;481;6557;
4809510;Mende-2;6058;352;6410;
4802706;Grandrieu;81;4;85;
4802713;Saint-Etienne-du-Valdonnez;960;44;1004;
4812708;Marvejols;176;5;181;
4812711;Saint-Alban-sur-Limagnole;1125;15;1140;
4900701;Angers-1;42985;954;43939;
4900702;Angers-2;31296;750;32046;
4900703;Angers-3;23592;333;23925;
4900704;Angers-4;13170;415;13585;
4900705;Angers-5;26207;433;26640;
4900706;Angers-6;7412;75;7487;
4900707;Angers-7;8298;117;8415;
4906014;Doué-la-Fontaine;2107;48;2155;
4906019;Saumur;1413;33;1446;
4905014;Doué-la-Fontaine;1315;28;1343;
4905017;Les Ponts-de-Cé;9492;250;9742;
4909912;Cholet-1;42308;1348;43656;
4909913;Cholet-2;11609;522;12131;
4936710;Chalonnes-sur-Loire;1996;28;2024;
4936721;Tiercé;3750;55;3805;
4926114;Doué-la-Fontaine;5260;91;5351;
4926115;Longué-Jumelles;3464;74;3538;
4920004;Angers-4;5610;154;5764;
4920021;Tiercé;721;14;735;
4929210;Chalonnes-sur-Loire;1252;24;1276;
4929211;Chemillé-Melay;2150;27;2177;
5002502;Avranches;7785;465;8250;
5002515;Isigny-le-Buat;2370;91;2461;
5009905;Carentan;9516;180;9696;
5009918;Pont-Hébert;602;8;610;
5012906;Cherbourg-Octeville-1;16593;609;17202;
5012907;Cherbourg-Octeville-2;16432;533;16965;
5012908;Cherbourg-Octeville-3;8608;156;8764;
5012912;Équeurdreville-Hainneville;16617;531;17148;
5012914;La Hague;5046;119;5165;
5012924;Tourlaville;15904;418;16322;
5021501;Agon-Coutainville;2973;81;3054;
5021510;Coutances;200;3;203;
5053502;Avranches;398;11;409;
5053503;Bréhal;318;10;328;
5053515;Isigny-le-Buat;195;5;200;
5040004;Bricquebec;318;5;323;
5040005;Carentan;2960;34;2994;
5041211;Créances;568;11;579;
5041217;Les Pieux;2020;58;2078;
5043118;Pont-Hébert;196;4;200;
5043122;Saint-Lô-1;907;9;916;
5049209;Condé-sur-Vire;2284;51;2335;
5049218;Pont-Hébert;176;3;179;
5050222;Saint-Lô-1;7380;586;7966;
5050223;Saint-Lô-2;11736;297;12033;
5055001;Agon-Coutainville;3351;146;3497;
5055010;Coutances;237;1;238;
5056502;Avranches;2462;45;2507;
5056503;Bréhal;350;11;361;
5110803;Châlons-en-Champagne-1;20817;323;21140;
5110804;Châlons-en-Champagne-2;16859;808;17667;
5110805;Châlons-en-Champagne-3;7077;113;7190;
5123007;Épernay-1;7526;205;7731;
5123008;Épernay-2;15145;244;15389;
5145411;Reims-1;26438;732;27170;
5145412;Reims-2;20141;289;20430;
5145413;Reims-3;25168;400;25568;
5145414;Reims-4;9986;83;10069;
5145415;Reims-5;14349;191;14540;
5145416;Reims-6;25274;268;25542;
5145417;Reims-7;28705;419;29124;
5145418;Reims-8;8844;62;8906;
5145419;Reims-9;23555;672;24227;
5212105;Chaumont-1;8015;265;8280;
5212106;Chaumont-2;6110;320;6430;
5212107;Chaumont-3;7820;642;8462;
5244813;Saint-Dizier-1;4860;60;4920;
5244814;Saint-Dizier-2;10392;320;10712;
5244815;Saint-Dizier-3;8760;178;8938;
5306201;Azé;5089;288;5377;
5306203;Château-Gontier;11687;360;12047;
5313010;Laval-1;19169;1138;20307;
5313011;Laval-2;16458;686;17144;
5313012;Laval-3;14101;732;14833;
5316106;Évron;2746;53;2799;
5316115;Meslay-du-Maine;481;8;489;
5432908;Lunéville-1;11567;343;11910;
5432909;Lunéville-2;6720;53;6773;
5439512;Nancy-1;35817;558;36375;
5439513;Nancy-2;32542;495;33037;
5439514;Nancy-3;35927;404;36331;
5502902;Bar-le-Duc-1;7265;251;7516;
5502903;Bar-le-Duc-2;7720;349;8069;
5554516;Verdun-1;9925;629;10554;
5554517;Verdun-2;7550;345;7895;
5612108;Lorient-1;29342;973;30315;
5612109;Lorient-2;27807;495;28302;
5619710;Moréac;2353;69;2422;
5619713;Ploërmel;352;6;358;
5626019;Vannes-1;32205;1363;33568;
5626020;Vannes-2;10554;437;10991;
5626021;Vannes-3;10593;270;10863;
5746311;Metz-1;37264;560;37824;
5746312;Metz-2;39983;735;40718;
5746313;Metz-3;39182;529;39711;
5767226;Thionville;39138;768;39906;
5767227;Yutz;1563;19;1582;
5819411;Nevers-1;7600;388;7988;
5819412;Nevers-2;6218;67;6285;
5819413;Nevers-3;8955;233;9188;
5819414;Nevers-4;10217;419;10636;
5918316;Dunkerque-1;51390;517;51907;
5918317;Dunkerque-2;35647;790;36437;
5918320;Grande-Synthe;316;7;323;
5935023;Lille-1;18952;275;19227;
5935024;Lille-2;6909;71;6980;
5935025;Lille-3;50567;398;50965;
5935026;Lille-4;47199;393;47592;
5935027;Lille-5;73075;654;73729;
5935028;Lille-6;36085;264;36349;
5951232;Roubaix-1;74467;318;74785;
5951233;Roubaix-2;22523;184;22707;
5959937;Tourcoing-1;21689;83;21772;
5959938;Tourcoing-2;75679;577;76256;
6005701;Beauvais-1;35258;674;35932;
6005702;Beauvais-2;20996;654;21650;
6015906;Compiègne-1;15435;478;15913;
6015907;Compiègne-2;24764;558;25322;
6100102;Alençon-1;15279;590;15869;
6100103;Alençon-2;10569;154;10723;
6100604;Argentan-1;7844;234;8078;
6100605;Argentan-2;5979;151;6130;
6148307;Bagnoles-de-l'Orne;2368;43;2411;
6148312;La Ferté-Macé;325;8;333;
6115304;Argentan-1;238;8;246;
6115315;Magny-le-Désert;1931;45;1976;
6116812;La Ferté-Macé;5110;401;5511;
6116815;Magny-le-Désert;127;2;129;
6116913;Flers-1;7236;134;7370;
6116914;Flers-2;7498;225;7723;
6204102;Arras-1;14456;159;14615;
6204103;Arras-2;15937;512;16449;
6204104;Arras-3;10626;123;10749;
6216013;Boulogne-sur-Mer-1;22727;187;22914;
6216014;Boulogne-sur-Mer-2;18147;259;18406;
6219318;Calais-1;23939;298;24237;
6219319;Calais-2;5993;47;6040;
6219320;Calais-3;43979;325;44304;
6242727;Hénin-Beaumont-1;9182;114;9296;
6242728;Hénin-Beaumont-2;16840;249;17089;
6311310;Clermont-Ferrand-1;22428;145;22573;
6311311;Clermont-Ferrand-2;24192;444;24636;
6311312;Clermont-Ferrand-3;23628;287;23915;
6311313;Clermont-Ferrand-4;21837;273;22110;
6311314;Clermont-Ferrand-5;26595;627;27222;
6311315;Clermont-Ferrand-6;25206;970;26176;
6322605;Billom;1922;51;1973;
6322624;Pont-du-Château;1490;23;1513;
6402401;Anglet;23455;833;24288;
6402404;Bayonne-1;15474;396;15870;
6410204;Bayonne-1;5781;164;5945;
6410205;Bayonne-2;19240;217;19457;
6410206;Bayonne-3;26207;789;26996;
6442214;Oloron-Sainte-Marie-1;6932;425;7357;
6442215;Oloron-Sainte-Marie-2;3752;196;3948;
6444518;Pau-1;25658;398;26056;
6444519;Pau-2;19411;243;19654;
6444520;Pau-3;14432;548;14980;
6444521;Pau-4;17629;216;17845;
6528605;Lourdes-1;7012;189;7201;
6528606;Lourdes-2;6377;114;6491;
6544010;Tarbes-1;13738;286;14024;
6544011;Tarbes-2;13811;175;13986;
6544012;Tarbes-3;13969;611;14580;
6613606;Perpignan-1;29038;290;29328;
6613607;Perpignan-2;14832;311;15143;
6613608;Perpignan-3;14143;224;14367;
6613609;Perpignan-4;24055;308;24363;
6613610;Perpignan-5;20792;200;20992;
6613611;Perpignan-6;17298;190;17488;
6748217;Strasbourg-1;46972;348;47320;
6748218;Strasbourg-2;43902;271;44173;
6748219;Strasbourg-3;47771;194;47965;
6748220;Strasbourg-4;43475;570;44045;
6748221;Strasbourg-5;40484;670;41154;
6748222;Strasbourg-6;58362;726;59088;
6737202;Bouxwiller;140;0;140;
6737213;Reichshoffen;4956;65;5021;
6806604;Colmar-1;39175;514;39689;
6806605;Colmar-2;29930;539;30469;
6822410;Mulhouse-1;40195;444;40639;
6822411;Mulhouse-2;41553;353;41906;
6822412;Mulhouse-3;27695;372;28067;
6917908;Mornant;2695;38;2733;
6917909;Saint-Symphorien-d'Ozon;1318;35;1353;
6913503;Belleville;116;6;122;
6913511;Thizy-les-Bourgs;1789;35;1824;
7024508;Luxeuil-les-Bains;237;3;240;
7024513;Saint-Loup-sur-Semouse;3566;125;3691;
7028503;Héricourt-1;2489;47;2536;
7028504;Héricourt-2;8112;233;8345;
7031006;Lure-1;4733;147;4880;
7031007;Lure-2;3474;55;3529;
7055015;Vesoul-1;5059;159;5218;
7055016;Vesoul-2;9857;653;10510;
7101401;Autun-1;7926;497;8423;
7101402;Autun-2;5364;594;5958;
7107605;Chalon-sur-Saône-1;11016;166;11182;
7107606;Chalon-sur-Saône-2;21024;770;21794;
7107607;Chalon-sur-Saône-3;13056;571;13627;
7115312;Le Creusot-1;12344;160;12504;
7115313;Le Creusot-2;9286;145;9431;
7127021;Mâcon-1;14040;229;14269;
7127022;Mâcon-2;19598;550;20148;
7218110;Le Mans-1;20532;319;20851;
7218111;Le Mans-2;15868;295;16163;
7218112;Le Mans-3;29214;878;30092;
7218113;Le Mans-4;21643;462;22105;
7218114;Le Mans-5;23884;547;24431;
7218115;Le Mans-6;22984;222;23206;
7218116;Le Mans-7;8821;107;8928;
7300801;Aix-les-Bains-1;7849;167;8016;
7300802;Aix-les-Bains-2;21945;412;22357;
7301103;Albertville-1;10228;320;10548;
7301104;Albertville-2;8671;234;8905;
7306507;Chambéry-1;20644;702;21346;
7306508;Chambéry-2;18453;464;18917;
7306509;Chambéry-3;19822;396;20218;
7401001;Annecy-1;25764;405;26169;
7401002;Annecy-2;36721;1120;37841;
7401003;Annecy-le-Vieux;24949;885;25834;
7401016;Seynod;39490;841;40331;
7421205;Bonneville;1134;17;1151;
7421208;Faverges;664;16;680;
7621707;Dieppe-1;17967;407;18374;
7621708;Dieppe-2;11113;151;11264;
7635114;Le Havre-1;38169;394;38563;
7635115;Le Havre-2;10721;115;10836;
7635116;Le Havre-3;24255;129;24384;
7635117;Le Havre-4;35464;292;35756;
7635118;Le Havre-5;32600;604;33204;
7635119;Le Havre-6;28938;386;29324;
7654028;Rouen-1;37898;642;38540;
7654029;Rouen-2;35034;621;35655;
7654030;Rouen-3;37213;352;37565;
7657531;Saint-Étienne-du-Rouvray;21607;219;21826;
7657534;Sotteville-lès-Rouen;7034;61;7095;
7668127;Le Petit-Quevilly;7497;177;7674;
7668134;Sotteville-lès-Rouen;21468;267;21735;
7603420;Luneray;2271;22;2293;
7603423;Neufchâtel-en-Bray;284;2;286;
7864620;Versailles-1;65103;1662;66765;
7864621;Versailles-2;20759;376;21135;
7901302;Bressuire;258;5;263;
7901307;Mauléon;2927;81;3008;
7919110;Niort-1;19948;520;20468;
7919111;Niort-2;18954;642;19596;
7919112;Niort-3;19805;637;20442;
8000101;Abbeville-1;12522;323;12845;
8000102;Abbeville-2;10424;89;10513;
8002106;Amiens-1;27836;160;27996;
8002107;Amiens-2;15940;180;16120;
8002108;Amiens-3;15906;104;16010;
8002109;Amiens-4;13498;314;13812;
8002110;Amiens-5;20298;419;20717;
8002111;Amiens-6;22368;1182;23550;
8002112;Amiens-7;18211;338;18549;
8062519;Moreuil;1101;8;1109;
8062522;Roye;403;2;405;
8100401;Albi-1;15935;739;16674;
8100402;Albi-2;11387;443;11830;
8100403;Albi-3;8758;374;9132;
8100404;Albi-4;12890;233;13123;
8106005;Carmaux-1 Le Ségala;5669;94;5763;
8106006;Carmaux-2 Vallée du Cérou;3831;65;3896;
8106507;Castres-1;17372;491;17863;
8106508;Castres-2;9818;440;10258;
8106509;Castres-3;14446;515;14961;
8116316;Mazamet-1;2524;42;2566;
8116317;Mazamet-2 Vallée du Thoré;7489;408;7897;
8121802;Albi-2;3015;74;3089;
8121822;Saint-Juéry;446;9;455;
8212106;Montauban-1;19752;394;20146;
8212107;Montauban-2;19704;654;20358;
8212108;Montauban-3;21354;432;21786;
8306105;Fréjus;41432;587;42019;
8306114;Saint-Raphaël;11240;253;11493;
8306902;La Crau;7857;94;7951;
8306908;Hyères;47731;889;48620;
8312616;La Seyne-sur-Mer-1;54222;589;54811;
8312617;La Seyne-sur-Mer-2;9714;192;9906;
8313719;Toulon-1;49784;341;50125;
8313720;Toulon-2;45016;398;45414;
8313721;Toulon-3;26185;438;26623;
8313722;Toulon-4;50968;630;51598;
8400702;Avignon-1;30577;444;31021;
8400703;Avignon-2;33386;787;34173;
8400704;Avignon-3;27958;519;28477;
8519112;La Roche-sur-Yon-1;25697;1873;27570;
8519113;La Roche-sur-Yon-2;28675;1121;29796;
8605311;Migné-Auxances;1100;23;1123;
8605319;Vouneuil-sous-Biard;825;12;837;
8606602;Châtellerault-1;8405;222;8627;
8606603;Châtellerault-2;9444;239;9683;
8606604;Châtellerault-3;13991;303;14294;
8619413;Poitiers-1;16870;461;17331;
8619414;Poitiers-2;16720;894;17614;
8619415;Poitiers-3;26531;607;27138;
8619416;Poitiers-4;16165;335;16500;
8619417;Poitiers-5;12005;115;12120;
8628107;Jaunay-Clan;3195;45;3240;
8628111;Migné-Auxances;2351;51;2402;
8708508;Limoges-1;18650;295;18945;
8708509;Limoges-2;15343;141;15484;
8708510;Limoges-3;16897;187;17084;
8708511;Limoges-4;16417;140;16557;
8708512;Limoges-5;8060;569;8629;
8708513;Limoges-6;17841;349;18190;
8708514;Limoges-7;14267;208;14475;
8708515;Limoges-8;15955;308;16263;
8708516;Limoges-9;8745;88;8833;
8712802;Ambazac;618;9;627;
8712803;Bellac;704;7;711;
8702803;Bellac;1155;28;1183;
8702804;Châteauponsac;516;7;523;
8816005;Épinal-1;13475;505;13980;
8816006;Épinal-2;18265;903;19168;
8841313;Saint-Dié-des-Vosges-1;11199;253;11452;
8841314;Saint-Dié-des-Vosges-2;8408;277;8685;
8902401;Auxerre-1;8169;458;8627;
8902402;Auxerre-2;6784;166;6950;
8902403;Auxerre-3;8536;396;8932;
8902404;Auxerre-4;11145;262;11407;
8938716;Sens-1;15827;301;16128;
8938717;Sens-2;10108;283;10391;
9001002;Belfort-1;15986;308;16294;
9001003;Belfort-2;17221;263;17484;
9001004;Belfort-3;14449;196;14645;
9111407;Épinay-sous-Sénart;5644;66;5710;
9111421;Yerres;20025;361;20386;
9142106;Draveil;6196;93;6289;
9142119;Vigneux-sur-Seine;17579;197;17776;
9200402;Asnières-sur-Seine;68477;510;68987;
9200412;Courbevoie-1;16714;174;16888;
9201204;Boulogne-Billancourt-1;67544;808;68352;
9201205;Boulogne-Billancourt-2;52527;370;52897;
9202510;Colombes-1;71580;454;72034;
9202511;Colombes-2;13597;144;13741;
9202612;Courbevoie-1;50135;414;50549;
9202613;Courbevoie-2;31584;194;31778;
9205019;Nanterre-1;64552;367;64919;
9205020;Nanterre-2;30553;267;30820;
9300805;Bobigny;51015;166;51181;
9300806;Bondy;2625;8;2633;
9302904;Le Blanc-Mesnil;7689;23;7712;
9302908;Drancy;63629;264;63893;
9303109;Épinay-sur-Seine;22285;59;22344;
9303118;Saint-Ouen;32799;94;32893;
9304812;Montreuil-1;46134;219;46353;
9304813;Montreuil-2;63763;358;64121;
9306616;Saint-Denis-1;70019;221;70240;
9306617;Saint-Denis-2;41116;592;41708;
9401703;Champigny-sur-Marne-1;51932;243;52175;
9401704;Champigny-sur-Marne-2;25698;119;25817;
9402807;Créteil-1;44781;220;45001;
9402808;Créteil-2;45824;295;46119;
9405205;Charenton-le-Pont;943;19;962;
9405214;Nogent-sur-Marne;31908;208;32116;
9406817;Saint-Maur-des-Fossés-1;61686;753;62439;
9406818;Saint-Maur-des-Fossés-2;13173;147;13320;
9407806;Choisy-le-Roi;20906;63;20969;
9407821;Villeneuve-Saint-Georges;12639;28;12667;
9408009;Fontenay-sous-Bois;9151;51;9202;
9408023;Vincennes;40740;325;41065;
9408124;Vitry-sur-Seine-1;47859;238;48097;
9408125;Vitry-sur-Seine-2;45698;264;45962;
9501801;Argenteuil-1;11803;62;11865;
9501802;Argenteuil-2;62901;287;63188;
9501803;Argenteuil-3;35506;280;35786;
9512704;Cergy-1;46514;241;46755;
9512705;Cergy-2;18663;229;18892;

